###########################
#............#............#
#.####.#####.#.#####.####.#
#@####.#####.#.#####.####@#
#.####.#####.#.#####.####.#
#.........................#
#.####.#.#########.#.####.#
#......#.....#.....#......#
######.####  #  ####.######
#    #.#           #.#    #
######.#           #.######
.......      G      .......
######.#   #####   #.######
#    #.#           #.#    #
######.#   #####   #.######
#............#............#
#.####.#####.#.#####.####.#
#@...#.......P.......#...@#
####.#.#.#########.#.#.####
#......#.....#.....#......#
#.##########.#.##########.#
#.........................#
###########################