###########################
#............#............#
#.####.#####.#.#####.####.#
#@####.#####.#.#####.####@#
#.####.#####.#.#####.####.#
#.........................#
#.####.#.#########.#.####.#
#......#.....#.....#......#
######.#####.#.#####.######
#    #.#...........#.#    #
######.#.#### ####.#.######
.........#   G   #.........
######.#.# ##### #.#.######
#    #.#...........#.#    #
######.#.#########.#.######
#............#............#
#.####.#####.#.#####.####.#
#@...#.......P.......#...@#
####.#.#.#########.#.#.####
#......#.....#.....#......#
#.##########.#.##########.#
#.........................#
###########################